▲▲▲^⌂⌂⌂▲▲▲≈≈≈^≈≈≈⌂▲▲≈≈▲▲▲▲▲▲^▲▲▲▲▲▲▲▲▲▲▲▲▲^▲▲▲~~~≈≈≈≈≈≈
≈≈▲▲▲⌂▲≈≈≈≈≈≈▲≈≈≈≈≈≈≈▲▲▲▲▲▲▲▲▲▲▲▲▲▲⌂⌂⌂▲▲▲▲▲▲▲^~~~≈≈≈≈≈≈
≈≈≈≈≈≈≈≈≈≈≈≈≈≈▲▲▲▲▲▲⌂⌂⌂  ⌂⌂⌂▲^^▲      ▲▲▲⌂⌂▲▲▲▲~~~≈≈≈≈≈
≈≈≈≈≈≈≈≈≈▲▲▲▲▲▲⌂⌂▲▲▲▲▲  ▲▲▲▲▲▲▲▲ ☼  ☼     ○^^▲▲▲~~≈≈▲≈^
▲▲≈≈≈≈▲▲▲▲▲▲▲▲ ☼ ☼  ▲  ▲▲▲▲▲▲▲^^      ☼   ☼  ^^▲▲~~≈≈≈≈
 ▲▲▲▲▲▲▲▲▲▲☼  ▲▲▲⌂▲▲☼ ▲^^▲▲▲▲▲▲▲           ▲ ▲▲▲▲~~≈≈≈≈
     ▲▲▲⌂▲▲ ▲▲▲⌂⌂▲▲▲ ▲⌂⌂⌂▲▲▲▲⌂⌂⌂▲▲ ☼   ☼    ▲▲▲⌂⌂▲~~≈≈≈
▲ ☼   ▲▲▲^^▲▲⌂⌂▲^▲▲▲ ⌂▲▲ ⌂▲▲▲         ▲    ▲▲▲▲▲⌂▲▲~~~≈
▲▲▲▲ ☼ ▲▲▲⌂▲▲⌂⌂⌂▲▲▲▲  ▲       ▲⌂⌂▲^▲▲▲ ▲ ^▲▲▲ ^⌂⌂▲▲▲~~~
▲▲⌂⌂▲  ☼▲▲▲▲^▲▲▲^▲▲▲▲ ▲☼  ▲^⌂▲▲▲^^▲▲▲▲▲▲▲▲▲▲▲⌂⌂▲▲▲▲▲▲~~
⌂▲▲▲⌂▲    ▲▲▲▲▲⌂▲^▲▲      ▲^▲▲▲▲⌂⌂⌂⌂⌂⌂▲▲▲▲▲▲⌂⌂^▲▲▲▲▲▲▲▲
⌂▲▲▲▲▲▲▲  ☼     ☼   ▲ ▲▲▲▲▲▲^⌂▲▲▲▲▲▲▲▲▲⌂▲▲▲▲▲▲▲⌂^▲▲▲▲▲▲
▲▲^^▲▲⌂▲▲ ▲▲▲▲▲▲▲▲☼    ▲▲▲▲▲▲▲^▲▲▲▲▲⌂⌂▲▲▲  ☼    ▲▲▲▲▲▲▲
▲▲▲▲▲▲▲▲▲ ▲▲▲▲▲⌂▲▲▲▲▲▲ ☼▲▲▲▲▲⌂▲▲▲▲^^▲▲▲▲    ○     ▲▲▲▲▲
▲⌂▲▲▲▲⌂▲   ▲▲^⌂⌂▲▲▲▲▲▲▲⌂ ☼▲▲▲▲⌂⌂▲▲⌂▲▲▲ ☼ ^⌂   ☼ ▲ ▲▲▲^^
▲▲⌂▲▲^⌂  ☼ ▲⌂⌂▲▲▲▲▲▲⌂▲▲▲⌂▲  ⌂▲▲▲▲▲         ☼      ▲▲▲▲▲
▲▲^⌂☼      ▲▲▲▲▲^▲▲⌂⌂▲▲▲▲⌂⌂     ▲^⌂  ▲ ☼ ▲    ^▲ ▲▲▲▲▲▲
▲▲▲▲   ☼  ▲▲▲▲▲⌂⌂▲▲^⌂▲⌂⌂▲▲▲▲▲▲▲▲            ^▲^  ▲▲▲▲▲⌂
▲⌂⌂▲▲ ☼  ☼▲▲▲▲⌂⌂▲▲⌂⌂▲▲▲⌂▲▲^▲▲⌂▲▲^^^⌂⌂▲▲ ☼      ▲▲⌂⌂▲▲▲⌂
▲▲▲▲    ☼   ▲▲⌂▲▲⌂▲▲▲▲▲⌂▲▲▲▲▲⌂▲▲⌂▲▲▲⌂▲▲▲▲^^▲▲⌂▲▲▲▲▲▲▲▲▲