≈~~~~≈≈≈≈~≈≈≈≈≈~≈≈~≈≈≈≈≈≈≈≈≈≈≈≈≈≈≈≈≈≈≈~~~~≈≈≈~~~▲▲▲▲▲▲▲
≈≈~~≈≈≈≈≈≈≈≈≈~~~~≈≈≈≈≈≈~~~~≈≈≈≈~~~~~≈≈≈≈≈≈≈~~~~▲▲▲▲▲▲▲▲
≈≈≈≈≈≈≈~~~~~▲▲▲▲▲▲▲▲▲▲▲▲▲▲▲▲▲▲▲▲▲▲▲~~~~~~~~~~~▲▲▲▲▲▲▲▲▲
≈≈~~~~~~~~▲▲▲▲       ▲▲▲▲▲▲▲▲▲▲▲▲▲▲▲▲▲~~~▲▲▲▲▲▲▲▲▲▲▲▲▲▲
~~~~▲~▲▲▲▲▲▲▲▲ ☼     ☼     ☼    ☼   ▲▲▲▲▲▲▲▲▲▲▲   ▲▲▲▲▲
~~~~▲▲▲▲▲▲▲▲  ☼         ☼           ▲▲▲▲▲▲▲    ☼   ▲▲▲▲
~~~~▲▲▲▲▲▲▲▲        ☼              ▲▲▲▲▲☼          ▲▲▲▲
~~▲▲▲▲▲▲▲▲▲▲☼      ☼     ☼   ☼              ☼      ▲▲▲▲
~~~~▲▲▲▲▲▲▲▲▲▲                   ▲▲▲▲▲▲           φ▲▲▲▲
~~~~~~▲▲▲▲▲▲▲▲▲▲▲ ☼        ▲▲▲▲▲▲▲▲▲▲▲▲▲   ☼      ╨▲▲▲▲
▲▲~~~~~~▲▲▲▲▲▲▲▲▲▲▲▲    ☼   ▲▲▲▲▲▲▲▲▲▲▲▲          ▲▲▲▲▲
▲▲▲▲▲~~~~▲▲▲▲▲▲▲▲▲▲▲▲▲▲      ▲▲▲▲▲▲▲▲▲▲▲▲☼    ☼  ▲▲▲▲▲▲
▲▲▲▲▲▲~~~~▲▲▲▲▲▲▲▲▲▲▲▲▲▲   ▲  ▲▲▲▲▲▲▲▲▲▲▲▲▲▲   ▲▲▲▲▲▲▲▲
▲▲▲▲▲~~~~~~~▲▲▲▲▲▲▲▲▲▲▲▲▲  ▲▲▲  ▲▲▲▲▲▲▲▲▲▲▲▲▲▲▲▲▲▲▲▲▲~~
▲▲~~~▲▲▲ ▲▲~~~▲▲▲▲▲▲▲▲▲▲▲   ▲▲▲   ▲▲▲▲▲▲▲▲▲▲▲▲▲▲~~~~~~~
▲~~▲▲▲    ☼▲▲~~~~~~~▲▲▲▲~~~~▲▲▲▲▲▲ ▲▲▲▲~~~~~~~~~~~▲▲▲▲▲
~~▲▲▲  ☼    ▲▲▲▲▲▲▲~~~~~~~~~~~~~~~~~~~~~~~~~~~▲▲▲▲▲▲▲▲▲
~▲▲▲▲  ○ ☼☼  ▲▲▲▲▲▲▲▲▲▲▲~~~~~~~~~~~~~▲▲▲▲▲▲▲▲▲▲▲▲▲▲▲▲▲▲
▲▲▲▲▲☼  ☼  ▲▲▲▲▲▲▲▲▲▲▲▲▲▲▲▲▲▲▲▲▲▲▲▲▲▲▲▲▲▲▲▲▲▲▲▲▲▲▲▲▲▲▲▲
▲▲▲▲▲▲▲▲▲▲▲▲▲▲▲▲▲▲▲▲▲▲▲▲▲▲▲▲▲▲▲▲▲▲▲▲▲▲▲▲▲▲▲▲▲▲▲▲▲▲▲▲▲▲▲