▲▲≈≈▲▲▲▲▲▲▲▲▲▲▲^▲▲▲    ○    ⌂▲⌂▲≈≈≈≈≈≈▲▲▲▲▲▲▲▲▲▲▲▲⌂▲▲▲▲
▲▲≈≈≈▲▲▲▲▲▲▲▲▲▲▲▲▲  ☼    ☼    ⌂⌂▲≈≈≈≈≈≈≈≈≈≈≈▲▲▲▲▲^▲⌂▲≈≈
▲▲▲▲≈≈▲○^▲▲▲▲▲▲▲▲▲     ☼   ☼  ▲▲▲▲▲▲▲▲▲▲⌂▲▲≈≈≈▲▲▲▲^▲≈≈≈
▲▲^≈≈≈≈~≈≈≈≈▲▲▲▲▲▲      ☼    ▲▲▲▲▲▲▲▲⌂^^▲⌂⌂⌂≈≈≈≈≈≈≈≈≈≈≈
▲▲^▲▲≈≈~≈≈≈≈≈⌂▲▲▲▲▲☼        ⌂⌂⌂▲▲  ☼     ▲▲▲▲⌂▲▲▲▲^▲▲▲▲
▲▲▲▲▲≈≈~~~~≈≈▲▲▲▲▲▲▲▲▲▲▲ ▲▲▲▲▲▲▲   ☼ ☼    ▲▲▲⌂⌂▲▲☼     
▲⌂▲▲▲≈≈≈≈≈~≈▲▲▲▲▲▲▲▲▲ ☼     ▲▲▲  ☼     ☼  ▲▲▲▲⌂⌂▲  ⌂▲  
▲▲▲▲▲▲▲▲▲▲~~^▲▲▲▲▲▲☼      ☼         ☼    ▲▲▲▲▲▲▲  ^▲⌂▲▲
▲▲⌂  ▲▲▲▲▲~~▲^        ☼               ☼ ▲▲▲▲▲▲▲▲  ▲▲▲▲▲
▲▲☼     ☼  ~~     ▲    ☼  ☼   ▲⌂▲  ▲▲⌂⌂⌂▲▲▲▲▲▲▲▲ ▲▲▲▲▲▲
▲▲   ☼     ▲▲~~▲▲▲▲▲▲     ☼ ▲▲▲▲⌂    ▲▲     ▲▲▲  ▲▲▲▲▲▲
▲⌂ ○   ☼   ▲▲▲~▲▲▲^▲▲▲▲ ⌂⌂   ▲▲⌂▲⌂⌂ ☼   ▲^^ ▲▲▲  ▲^^^▲▲
▲⌂▲▲    ▲⌂⌂⌂▲~~▲▲▲^▲▲▲  ▲▲⌂▲  ▲▲▲^▲      ▲▲ ☼▲▲▲ ☼▲▲▲⌂▲
~▲⌂⌂▲▲▲▲▲⌂^▲~~⌂⌂⌂⌂▲▲▲⌂  ▲▲▲⌂▲   ▲▲▲▲▲   ☼     ▲▲  ▲⌂▲⌂▲
~~~~▲▲▲▲▲~~~~▲▲▲▲▲⌂▲   ▲▲▲▲▲♠▲     ▲▲▲      ☼  ▲▲  ▲▲▲▲
▲▲▲~~~~~~~▲▲▲^~~~~▲▲ ╔  ▲▲▲▲♠≈^▲▲▲   ▲▲▲▲▲▲▲▲▲⌂⌂▲  ▲▲▲▲
▲▲▲▲~▲▲▲▲~▲▲~~~~~~▲^  ☼ ⌂⌂▲♠≈≈≈≈≈♠▲▲       ▲▲▲▲    ▲▲▲▲
▲▲~~~~▲▲▲~~▲~~~~~~▲▲     ▲♣♣≈≈≈≈≈≈♠♣▲▲▲▲▲▲☼      ⌂▲▲▲▲▲
▲▲▲▲~~~~~~~~~~~~▲▲▲☼   ☼ ▲▲▲♠≈≈≈≈≈≈≈⌂▲▲^^▲▲▲▲⌂⌂⌂▲⌂⌂▲▲▲▲
▲▲▲▲▲▲▲▲▲⌂▲▲▲▲▲^▲▲▲^ ║  ^ ▲▲♠▲≈≈≈≈▲≈♠▲▲▲▲▲▲▲▲▲^^⌂▲⌂▲▲▲▲