▲▲▲^        ▲▲▲▲▲▲▲▲⌂▲▲▲▲▲^▲▲⌂⌂▲▲^▲▲▲▲▲▲▲▲▲▲▲▲▲▲▲▲▲▲▲▲▲
▲▲           ▲▲▲▲▲▲▲▲▲▲▲▲▲▲▲▲⌂▲^▲▲▲▲▲▲▲▲▲▲▲'○○'▲▲▲▲▲⌂▲▲
▲            ▲▲▲⌂▲▲▲▲⌂⌂▲▲▲▲▲▲▲▲▲▲⌂⌂▲▲▲▲▲▲▲^''''▲▲▲▲▲▲▲▲
▲            ▲▲▲▲⌂⌂⌂▲▲▲▲▲▲^▲''''''▲▲▲▲▲▲'''''▲^▲▲▲^^▲▲▲
▲          ▲^^▲▲▲▲'''''''''''''''''''''''''▲▲▲▲▲▲▲▲▲▲▲▲
▲▲   ▲⌂▲▲▲▲▲▲▲▲▲▲''''▲▲''⌂⌂▲▲^▲▲▲▲▲▲▲▲▲▲▲▲▲^▲▲⌂▲▲▲⌂▲▲▲≈
▲▲▲▲▲▲▲▲''''''☼'''''▲▲▲▲▲▲▲▲▲^▲▲▲▲''''''''''▲▲▲▲▲^▲▲▲≈≈
''*'''''''☼'''''☼'''☼'▲▲⌂▲▲▲▲▲'''♠'♠♠♠'♠''♠''''▲▲▲▲▲≈≈≈
''''☼'''''☼'''☼'''☼''☼''''☼'''*''''♠'♠'♠''♠♠'♠''~~≈≈≈≈≈
''☼''''☼'''''''''☼''''''☼''''''''╔══════╗'♠♠♠'''~~≈≈≈≈≈
'''☼'''☼''*'''''''''╔════════════╝♠'♠'♠'║'''♠''~~~≈≈≈~~
''''''''╔═══════════╝''*'''''☼'''''♠'♠♠'║'♠''♠~~~≈≈≈≈≈≈
════════╝'''''''''''''''☼''☼''''☼''☼''♠'║''♠''~~~≈≈≈≈≈≈
'''''''''*''''☼''*'''''''☼''☼''''''''''╔╝'♠'''~~~≈≈≈≈~~
'''''''''''☼'''''''☼''☼''☼'''''☼'☼'''''║'♠'''~~~~~≈≈≈≈≈
''☼''☼'''☼''''☼''☼'○'''''''☼''''''*'''╔╝'''''~~~~≈≈≈≈≈≈
''''''''''''☼''''''''''''☼''''☼''''''╔╝''''''~~~~≈≈≈~~≈
'''''''☼''☼'''''''☼''☼'☼'''☼''''☼''''║'''''''~~~~≈≈≈≈≈≈
''''☼''''''''''☼'''''''''*'''☼''''''╔╝''''''''~~~~≈≈≈~≈
''''''''''''''''''''''''''''''''''''║'''''''''~~~~≈≈≈≈≈