▲▲▲▲▲▲^⌂▲⌂▲▲⌂▲▲▲^▲^▲▲▲▲▲▲⌂▲▲▲⌂▲▲⌂▲▲▲▲▲▲▲▲▲▲^▲▲▲▲▲▲▲^▲▲▲
▲▲^▲▲▲▲▲▲▲▲^▲⌂○'''''''▲▲▲▲⌂▲▲▲▲⌂▲▲▲▲^▲▲⌂▲▲▲▲▲▲∩∩∩∩∩∩▲▲'
▲▲▲⌂⌂▲▲^⌂▲▲▲▲⌂⌂'''''''''''''''▲⌂▲▲▲▲▲▲▲▲▲▲▲∩∩∩∩∩∩∩∩∩∩∩'
▲⌂▲▲▲▲▲▲▲▲▲▲▲▲⌂▲▲▲▲▲▲▲⌂▲▲▲▲''▲'''⌂▲▲∩∩∩∩∩∩∩∩∩∩∩∩∩∩∩∩∩∩∩
∩∩∩∩∩▲∩∩∩∩∩∩∩∩∩∩∩∩∩∩▲▲▲▲▲▲▲∩∩∩∩∩''∩∩∩∩∩∩∩∩∩∩∩∩∩∩∩∩∩∩∩∩∩
∩∩∩∩∩∩∩∩∩∩∩∩∩∩∩∩∩∩∩∩∩∩∩∩∩∩∩∩∩∩∩∩∩∩∩∩∩∩∩∩∩∩∩∩∩∩∩∩∩∩∩∩∩∩∩
∩∩∩∩∩∩∩∩∩∩∩∩∩∩∩∩∩∩∩∩∩∩∩∩∩∩∩∩∩∩∩∩∩∩∩∩∩¥∩∩∩∩∩∩∩¥∩∩∩∩∩∩∩∩∩
∩∩∩∩/─┴┬∩∩∩∩∩∩∩∩∩∩∩∩∩∩∩∩∩∩∩∩∩∩∩∩∩∩∩∩∩∩∩∩∩∩∩∩∩∩∩∩∩∩∩∩∩∩∩
∩∩∩──┐∩┐∩∩∩∩∩∩∩∩∩∩∩∩∩∩∩∩∩∩∩∩⌠∩∩∩∩∩∩∩∩∩∩∩∩∩∩∩∩∩∩∩∩∩∩∩∩∩∩
∩∩∩∩∩╡∩╪∩∩~∩∩∩∩∩∩∩∩∩~∩∩∩∩∩∩⌠⌠∩∩∩∩∩∩∩∩∩∩∩∩∩∩∩∩∩∩∩∩∩∩∩∩∩∩
∩∩∩∩∩│○│\∩∩∩∩∩∩∩∩∩∩┐∩∩∩∩∩∩∩⌠∩∩∩∩∩∩∩∩∩∩∩∩∩∩∩∩∩∩∩∩∩∩∩∩∩∩∩
∩∩∩∩∩╡∩┼┬∩∩∩∩∩∩∩∩∩∩∩∩∩∩∩∩∩∩∩∩∩∩∩∩∩∩∩∩∩∩∩∩∩∩∩∩∩∩∩⌠⌠∩∩∩∩∩
∩∩∩∩⌠∩∩┴┐∩∩∩∩∩∩~∩∩∩∩∩∩∩∩∩~∩∩∩∩∩∩∩∩∩∩∩∩∩∩∩∩∩~∩∩∩∩∩∩∩∩∩∩∩
∩∩∩∩∩∩∩∩├∩∩∩∩∩∩∩∩∩╦∩∩∩∩∩∩╒══∩∩∩¥∩∩∩∩¥∩∩∩∩∩═∩∩∩∩∩═∩∩═∩∩∩
∩∩∩∩∩∩∩∩∩∩∩∩∩∩∩∩∩∩∩∩∩∩∩∩∩∩∩∩∩∩∩∩∩∩∩∩∩∩∩∩∩∩∩∩∩∩∩∩∩∩∩∩∩∩∩
'∩∩∩∩∩∩∩∩∩∩∩∩∩∩∩∩¥∩∩∩∩∩⌠∩∩∩∩∩∩∩∩∩∩∩⌠∩∩∩∩∩∩∩∩∩∩∩∩∩∩∩∩∩∩∩
''∩∩∩∩∩∩∩∩⌠∩∩∩∩∩∩∩∩∩∩∩∩∩∩∩∩∩∩∩∩∩∩∩⌠⌠⌠∩∩∩∩∩∩∩∩∩∩∩∩∩∩∩∩∩∩
''∩∩∩∩∩∩∩∩∩∩∩∩∩∩~∩∩∩∩∩∩∩∩∩∩∩~∩∩∩∩∩∩∩∩∩∩∩∩∩∩∩∩∩∩∩∩∩∩∩∩∩∩
'''∩∩∩∩∩∩∩∩∩∩∩∩∩∩∩∩∩∩∩∩∩∩∩∩∩∩∩∩∩∩∩∩∩∩∩∩∩∩∩∩∩∩∩∩∩∩∩∩∩∩∩∩
''''∩∩∩∩∩∩∩∩∩∩∩∩∩∩∩∩∩∩∩∩∩∩∩∩∩∩∩∩∩∩∩∩∩∩∩∩∩∩∩∩∩∩∩∩∩∩∩∩∩∩∩
