▲''▲⌂▲▲▲▲▲▲⌂⌂▲^▲▲▲⌂⌂''''⌂'▲▲▲▲▲▲▲▲▲▲▲▲▲▲▲⌂▲^▲⌂▲▲▲⌂⌂▲^^'
'^^▲▲▲^^▲▲^▲▲▲⌂▲⌂▲⌂'⌂⌂║'''▲▲▲^▲▲▲▲▲^▲'○'▲▲▲⌂▲▲▲▲▲▲▲▲▲▲^
'○▲▲▲▲^^▲▲⌂⌂▲▲⌂▲^▲▲▲▲⌂╝⌂⌂○▲▲▲▲▲▲▲▲▲▲'''''▲▲⌂▲▲▲▲⌂⌂▲▲▲▲'
''^▲⌂▲▲⌂▲^▲▲▲^▲^▲▲▲⌂⌂''⌂⌂⌂▲▲▲▲▲▲▲▲▲⌂'''''▲▲▲▲▲▲▲^^▲▲▲▲'
∩''^▲▲▲^▲▲^▲▲▲▲▲▲⌂⌂⌂'║''⌂'▲▲▲▲⌂▲▲▲▲▲'''''▲▲▲▲▲▲▲▲▲^▲▲▲▲
∩∩'▲▲▲⌂⌂⌂⌂^▲▲▲▲⌂⌂⌂▲''║'⌂⌂▲▲▲▲▲▲▲▲▲▲''''▲▲⌂▲▲▲▲▲▲▲▲▲▲▲▲'
∩∩∩∩'¥¥^¥¥⌂⌂⌂^'⌂'▲▲'╔╝'▲▲⌂▲▲▲▲▲^▲▲⌂'''⌂▲▲▲▲▲▲▲▲▲▲▲▲▲▲▲▲
∩¥∩''''¥¥¥¥¥⌂'▲▲▲'''''▲'⌂▲▲▲▲▲▲▲▲▲▲''▲▲▲^▲▲▲^▲▲▲^▲⌂▲▲▲'
∩∩∩'''''''¥¥''''''''║''▲'⌂'▲⌂⌂▲⌂⌂▲▲''▲▲▲▲▲▲▲▲▲▲▲▲'▲¥¥¥'
∩∩∩∩'''┴''''''''''''║''▲'⌂⌂'▲''⌂¥'▲''▲⌂'''▲▲▲▲'''▲'¥¥''
∩∩∩'∩''''''''''''''╔╝''''''''''¥¥¥¥'''''┬''¥¥¥¥¥'''''''
∩~∩∩'''''''''''''''║''''''''╜'¥''''''''''''''''''''''''
∩∩∩∩∩∩'''''┼'''''''║''''''''''''''''''''''''''''╔══════
∩∩∩∩∩'''''''''''''╔╝''''''''''''''''╔═══════════╝''''''
∩~~∩∩∩∩'''''''''''║'''''╔═══════════╝''''''♠♠♠├'♠♠'''''
∩∩∩∩∩∩═∩══════════╬═════╝'''''''''''''''''''♠♠♠♣♠'♠''''
∩∩∩∩∩∩∩'''''''''''║'''''''''''''''''''''''┐'♠♠♠♣♠♣♠♠'''
∩¥∩~∩∩∩'∩''''''''╔╝'''''''''╞''''├'''┐''''♠♠♠♣≈♠≈≈♠♠'''
∩∩∩∩~∩∩∩∩'''┘''''║'''┐''''''''''''''''''''┐♠♠♠≈≈≈♠♣''''
∩∩∩∩∩¥∩∩∩∩'''''''║'''''''''''''''''''''''''''♣♠♠♠♠'''''
