∩∩∩∩∩∩∩∩∩∩'''''''║''''''''`''''`''''''''''`''''''''''''
∩∩~∩`∩∩∩`''`'''''║'''''''`''''''`````''''''''''`''''`''
∩∩∩∩∩∩∩''''''''''║'''`''''''''''╔══════════♠♣♣¥♠♠♠♠════
~∩∩∩`∩'''''''''''║'''`'''````''╔╝''''♣♠¥♠♠♠♣⌠♠♠~~~¥♣'''
∩∩`∩∩'''`''''♠'''║''''`'''''''╔╝'''♠¥¥♠¥♠~⌠⌠⌠~~~≈≈~~~''
`∩∩''''''''♠''♣♠♣║♣♣'''`''''╔═╝''''♠♣♠~~~☼≈≈≈≈≈≈≈☼≈≈~~'
'''''`'`'''''`♠♣'║♠♣♠'''''''║''''¥¥♠~~~≈≈≈≈≈~~~~≈≈≈≈≈~~
═════════════════╬══════════╝''''♠♠⌠~~☼≈≈≈≈≈≈≈≈≈≈≈≈≈☼≈~
''''''''`''''`♣♠♣║'♣♠'''''''''¥'♠¥⌠⌠~≈≈≈≈≈≈≈☼≈≈~~≈≈≈≈≈~
''`'''`'''`''''♠'║♠'♠'''''''''¥♠¥♠⌠≈☼≈≈≈≈≈≈≈≈≈~~≈≈≈≈≈≈~
'''''`''''''``'''║'♣''''''''''♠♠♣~~≈≈~~~≈≈≈≈≈☼≈≈☼≈≈⌠⌠⌠~
~~~~~~~~~~~''`'''║'''''~~~'''¥'~~~≈≈≈≈≈≈~~~~~~≈≈≈≈≈⌠⌠~'
''''''''~~~~~~~~├'┤'~~~~≈≈~~~~~~≈☼≈≈≈≈☼≈≈≈≈≈≈≈≈≈≈~~~~''
''``'''`'''~~~~~├'┤~~~~~~≈≈≈~~~~~~~~~~~~~~~~~~~☼~~~~'''
''''''''''''''''├'┤'`'''~~~~''''''''''``'''~~~~~'''''''
''`╘\''''`'''''''║'''''`'''''''''⌐''''`╤''╘''''''''''''
'``╩'''`'''''''''║'''''''`'''''''╒═┐''`├\''┌┬──┐``''''`
'''''`'''`'''''''║''''''''````'''╘`''`'`'''│○'''`''''''
'''╥'`'''''`''''│║│'`'''''''''`╘'''╫''`'```└┴─┼─┴''`'''
'`'''`'``┌──────┘║└──────┐`'``'''''``'''''''''``'''`'''
