''''☼''''''''☼''☼'''''''''''☼''''''♠║'''''''''~~~~≈≈≈≈≈
''''''''''☼'''☼''''☼''''☼''☼'''♣♠♠♠♠║♣♠''''''~~~~≈≈≈~≈≈
═════════╗'''''''''''''''''''''♠♣¥♠♠║¥♣♠'''''~~~≈≈≈≈~~≈
'''''''''╚═══════════════╦═╗'¥♠♠♠♠♠♣║♠♠♠''''~~~≈≈≈≈≈≈≈≈
'☼'''''☼'''''''''''''''''║'╚════════╝♠¥♠''''~~~≈≈~~≈≈≈≈
''''☼'''☼''''☼''''☼''''''║''♠♠♠♣♣♠♠♠♣♠♣''''''~~~≈≈≈≈~≈≈
'''''''''''☼'''''''''''''║'''''''¥'♠♠'''''''''~~≈≈≈≈~~≈
~'''''''⌠'''''''''''≈≈≈≈≈║≈≈≈≈≈''''''''''''''''~~~≈≈≈~≈
~''☼'⌠⌠⌠⌠'≈≈≈≈≈≈≈≈≈≈≈≈≈┌┘║└┐≈≈≈≈≈≈≈≈≈≈≈≈⌠⌠⌠'''~~~~≈≈≈≈≈
~''''⌠⌠≈≈≈≈≈≈≈≈≈≈≈≈≈≈≈≈│...│≈≈≈≈≈≈≈≈≈≈≈≈≈≈⌠⌠⌠''~~~≈≈≈≈≈
~'''''⌠≈≈┌──────────┬──┴...┴──┬─────────┐≈≈'⌠''~~~≈≈≈≈≈
'''''''≈≈│○.........│.........│....○....│≈≈''''~~≈≈≈≈≈≈
'☼'''''≈≈│..........│.........│.........│≈≈''''~~≈≈~~≈≈
'''☼'''≈≈│..........│.........│.........│≈≈''''~≈≈≈≈≈≈≈
'''''''≈≈│..........│.........│.........│≈≈''~~~≈≈≈≈≈≈≈
'''''⌠'≈≈│..........├───...───┤.........│≈≈'~~~~≈≈≈≈≈≈≈
'''''⌠⌠≈≈│..........│.........│.........│≈≈~~~~≈≈~~~≈≈≈
'☼''⌠⌠⌠≈≈│..............................│≈≈~~~≈≈≈≈≈≈≈≈≈
''''⌠⌠⌠≈≈│...............○..............│≈≈≈≈≈≈≈≈≈≈~~≈≈
'''''⌠⌠≈≈└──────────┴─────────┴─────────┘≈≈≈≈≈≈≈≈≈≈≈≈≈≈
