'''''∩∩∩∩∩∩∩∩∩∩∩∩∩∩∩~∩∩∩∩∩∩∩∩∩∩∩∩∩∩∩∩∩~~∩∩∩∩∩∩∩∩∩∩∩∩∩∩∩
'''''''''''∩∩∩∩∩~∩∩∩∩∩∩∩∩∩~∩∩∩∩∩∩~∩∩∩∩∩∩∩∩∩∩∩∩~~∩∩∩∩∩∩∩
'''''''''''∩'∩∩∩∩∩∩∩∩∩∩∩∩∩∩∩∩∩∩∩∩∩∩∩∩∩∩~∩∩∩∩∩∩∩∩∩∩∩∩∩~∩
''''╛''''''''∩''∩∩∩∩∩∩∩∩~∩∩∩∩∩∩∩∩∩∩∩∩∩∩∩∩∩∩∩∩∩∩∩∩∩∩∩∩∩∩
'''''''''''''''''∩∩∩∩∩∩~∩∩∩∩∩∩∩∩∩∩∩∩∩∩∩∩∩∩∩∩∩∩'∩''∩∩∩∩∩
''''''''''''''''∩'∩'∩∩∩∩∩∩∩∩∩∩~∩∩∩∩∩∩∩∩∩∩∩∩∩'∩'''''''∩∩
''''''''┘'''''''''∩∩'∩∩∩∩∩∩∩∩∩∩∩∩∩∩∩'∩'''''''''''''''''
'''''┤'''''''''╞'''''''∩∩∩∩∩∩∩∩∩∩∩'''''''''''''''''╔═══
''''''┤''''└─○─┐''''''''''∩'∩∩∩∩'''''''''''╔═══════╝'''
'''''''''''┴───╜'''''''''''''''''''╔═══════╝'''''''''''
''''''''''''''''''''''''''''╔══════╝''''~~~~~~~~~~~~~''
''''''''''╕'''''''''╔═══════╝'''''''~~~~~~~~~~~~~~~~~~~
''''''''''''╔═══════╝''''''''''''''~~~~~~''''''''''''''
''''╔═══════╝''''''''♠♠♠♠♠♠♣♠♠~~~~~~~~'''''''''''''''┘'
════╝'''''''''''''♠♣♠♠♠♣♠♠~~~~~~'''''''''''''''''''''''
''''''''╪─''''''♠♠♠♠♠~~~~~~♠♣♠♠♠'''''''''''''''''''''''
'''''''''''''''♠♠♠♠~~~~~♠♠♣♠♠♠♣♠♠'''''''┤'''''''╞╪'''''
''''''┘''''''''♠♠~~~♠♠♠♣♠♠♣♠♠♣♠♠''''''''┘''''''''''''''
''''''''''''''~~~~'♠♠♣♠♠♣♠♣♣♠♠'''''''''''''''''''''''''
''''''''''''~~~'''''''♠♠♣♠♠♠♣''''''''''''''''''''''''''
